e.###########################################################
..........#.......#.#.....#...#.........#.....#.#.....#.#.#.#
#.#####.#####.#####.###.#.#.###.#.###########.#.###.###.#.#.#
#...#.........#...#.....#.....#.#...........#.#.#...........#
#.###.#.#########.#########.#####.###.###.###.#.#.#.#####.#.#
#...#.#...#...#.......#...#.#.#.....#...#.......#.#.#...#.#.#
#########.#.#######.###.###.#.###.#.###.#.#.#.#.###.#.###.###
#.#...........#...#.#...#.....#...#...#.#.#.#.#.#...#.......#
#.#.###.#.#####.###.###.###.###.###.###############.#######.#
#...#.#.#.......#.......#.....#.#.....#.#.........#...#.....#
#####.#.###.#.#.#.###.#.#.###.#.###.#.#.#####.#############.#
#...#...#.#.#.#...#.#.#.#...#.#.#...#...#.......#...#.......#
#.#######.###.###.#.#######.#####.#.###.#.#.#.#####.#.#.###.#
#.#.....#.....#...#.#...#.#...#.#.#.#...#.#.#.#.......#...#.#
#.#.#.###.#.#####.#.###.#.###.#.###.#########.#.###.#.#.###.#
#...#...#.#...#...........#.......#.#.#.#.#.....#...#.#.#...#
###.###.#.#########.###.#######.###.#.#.#.###.###.#.#.###.#.#
#.....#.#...#.........#.#.#.#.....#.....#...#.#...#.#.#...#.#
#.#####.###.###.#####.###.#.###.###.#.###.###.#####.#####.###
#...#.....#...#.....#.#...#.........#.#.......#.#...#.......#
#.#######.#.###.#######.###.#.#####.#####.#.#.#.#.#.#.###.#.#
#.....#.......#...#.#.....#.#...#.......#.#.#.#.#.#.#.#...#.#
#####.#.#####.#.#.#.#.#.#####.#.###.###.#.#####.#.#.###.###.#
#.....#.#.#...#.#.#.#.#.#.#...#.#.#...#.#.#.#...#.#...#.#.#.#
#.#.#.###.###.#####.#.###.#######.###.###.#.###.#########.#.#
#.#.#.#...#.#.....#...........#.#.........#.#.......#.......#
#.#####.###.#.###.#####.#######.#####.#####.#.#.#######.#.#.#
#.#.....#.#...#.#...#...........#...........#.#.#.#...#.#.#.#
#.###.###.#.#.#.#####.#######.#########.#.###.###.###.#.#####
#...#...#.#.#...#...#...#.....#.....#...#.......#.#...#.....#
###.#.###.###.#.#.#.#####.#######.#####.#######.#.#.###.###.#
#.#...#.......#...#.#.....#.#.#...#...#...#...#.....#.#.#.#.#
#.#.###.#.###########.###.#.#.###.#.#.#.###.#######.#.###.###
#.....#.#.#.#.....#.#.#.#...#...#...#...#.#.....#.......#...#
#.#######.#.###.#.#.###.###.#.###########.###.###.#######.###
#...#...........#.....#...#.#...#.......#.....#.....#.#.....#
#.#####.#.#.#######.#.#.#.#.#.#.#.#######.#######.#.#.#.#.#.#
#...#...#.#...#.....#.#.#.#...#...#.......#.#.....#.#...#.#.#
#.#.#.#####.#.#######.#.#####.#####.#####.#.#####.###.#####.#
#.#.#.#.....#.#.....#.#.......#.....#...#.#.......#...#.....#
#.#####.###.###.###.###.#####.#.#####.###.###.#.#.#####.###.#
#...#...#.#.#.#...#.#.#.#...#...#...#...#.....#.#.#...#...#.#
#####.###.#.#.###.###.#.#.###.#.#.#.###.#.#.#######.###.#####
#...#...#...........#...#...#.#...#...#...#.#.#.......#...#.#
###.#.#.#############.#####.#####.#####.#.###.#####.#.#.#.#.#
#.....#.#.#.....#.#...#...........#.#...#.........#.#.#.#...#
#.###.###.#.#.###.###.###########.#.###.###.#.#.###.#.#.#####
#...#...#...#.#.....#...#.#...#.....#.....#.#.#.....#.......#
#.###.###.#.###.###.#.###.#.###.###########.#.#####.#######.#
#.#.#...#.#.......#...#.#.......#.....#.#.#.#...#.#.#.#.....#
#.#.###.###.###.#####.#.#.###.#####.###.#.###.#.#.#.#.#####.#
#...#.......#...#...#.#...#.....#.........#.#.#.#.....#.....#
###.#.#.#.#####.#.#.#.#######.###########.#.#.#####.#######.#
#.#.#.#.#.#...#...#.#.#.........#.......#...#...#...#...#...#
#.###.#.###.#.#.#################.#######.###.#.###.###.#####
#.#...#.#...#...#...#.....#...#.#.............#.#...#.......#
#.#.#####.#.#.#.#.#####.###.#.#.#.#######.#.#.#.###.###.###.#
#.....#.#.#.#.#.....#...#...#.....#.#.#.#.#.#.#.#.#.#...#...#
###.#.#.#.#.###.#.###.#####.#####.#.#.#.#.#.#####.#.#######.#
#...#...#.#...#.#.........#.#.......#.....#.....#...........#
###########################################################x#
