e.#######################################
..#.#.#.#...#.........#...#...#...#.....#
#.#.#.#.###.###.#####.###.###.#.###.#####
#.....#.......#.#.......#.............#.#
#.#.###.###.#.###.#.#######.###.###.###.#
#.#.......#.#.#...#.....#.....#.#.....#.#
#.###.#######.#.#.#################.###.#
#...#.#.#.......#.......#.....#...#.....#
#.###.#.###.#.#.###.###.#####.#.###.###.#
#.#.#...#...#.#...#.#.......#.........#.#
#.#.#######.#.#.#.#.#.###.###.###.###.###
#.....#...#.#.#.#.#.#...#.......#...#.#.#
###.#####.#.###########.#.#.#######.###.#
#.......#.#.....#...#.#.#.#.#.#.........#
#.###.###.#.###.#.###.#.#####.#.#.#######
#.#...#.#.#.#.#.#.....#...#.#.#.#.#.....#
###.###.#.###.#.#.###.#.###.#.#######.#.#
#...#...#.#.#...#.#...#.............#.#.#
#.#####.#.#.#.###.###.#.###.#########.###
#.....#.....#.#.#.#...#.#...#.#.........#
#.###.#.#.#.###.###.#.#.#.###.#.#######.#
#.#.....#.#.#.......#.#.#.#.........#...#
#.#.###########.#####.#.#.#####.###.#.#.#
#.#.#...........#.....#.#.#.#.#.#...#.#.#
###.#.###########.###.###.#.#.#.#.#####.#
#...........#.#...#.#.#...#...#.#.#.#...#
#########.#.#.###.#.#.#######.#.###.#.#.#
#.#...#...#.#.#.#...#.#.#.#.........#.#.#
#.###.#.#.#.#.#.#######.#.###.#.#####.###
#.....#.#.#...........#.#.#...#.#.....#.#
#####.#######.###.#.#.#.#.#.#####.###.#.#
#...#.#...#.....#.#.#.#.....#.....#.....#
###.#.###.#######.#.#.#.###.#.###.###.###
#.................#.#...#...#.#...#.....#
###.#####.#.#######.###########.#########
#.....#.#.#...#...#.#.......#.#.#.......#
###.###.#####.#.#####.###.#.#.#.#.#.#####
#.#.#...#.#.#...#...#.#...#.#.#...#.....#
#.#.#.###.#.#.#####.#.#.###.#.#.#####.#.#
#.........#.......#...#.#.........#...#.#
#######################################x#
