e.###################
............#.......#
###.###.#.#.###.###.#
#.....#.#.#...#.#...#
#.###############.#.#
#.........#...#...#.#
###.#.#######.#.#.#.#
#...#.......#...#.#.#
###.#####.#.#.#######
#.#.#.#...#.#.......#
#.###.#.#######.###.#
#...............#...#
#####.###########.###
#.....#...#.........#
#####.###.#######.###
#.#...#.#...........#
#.#.#.#.#.#######.#.#
#.#.#.#...#...#...#.#
#.###.#####.#.#####.#
#.........#.#.......#
###################x#